id,value
"KEN","1"
"BGD","1"
"SRB","1"
"ROU","2"
"FRA","4"
"KOR","1"
"HUN","2"
"Simferopol","1"
"GBR","2"
"DNK","1"
"DEU","9"
"SWE","1"
"CZE","1"
"CHN","3"
"ITA","3"
"CAN","11"
"IDN","1"
"HKG","1"
"678530","1"
"QAT","1"
"IND","5"
"IRN","1"
"UK","10"
"NLD","1"
"MYS","1"
"SGP","2"
"TUR","4"
"POL","4"
"USA","51"
"NZL","1"
"BGR","1"
"RUS","1"
"BRA","4"
"SVN","1"
"UKR","2"
"ESP","1"
