id,value
"","42"
"TX 79031","1"
"IL","1"
"NY","4"
"GA","1"
"DC","1"
"MN","1"
"CA","6"
"WA","1"
"MI","1"
"TX","1"
"CO","3"
"FL","1"
"IA","1"
"MD","1"
"NC","1"
