id,value
"PRT","1"
"AUS","3"
"ISR","6"
"SRB","2"
"ROU","1"
"GRC","1"
"Europe","2"
"FRA","5"
"EGY","1"
"HUN","1"
"GBR","6"
"CHE","3"
"DNK","1"
"NOR","1"
"DEU","23"
"SWE","8"
"CZE","1"
"CHN","1"
"ITA","4"
"FIN","1"
"JPN","3"
"Riyadh Saudi Arabia","1"
"CAN","17"
"HKG","1"
"IND","5"
"IRN","2"
"UK","17"
"MNG","1"
"LTU","1"
"NLD","3"
"MYS","1"
"TUR","4"
"POL","4"
"NZL","1"
"USA","80"
"ＥＡＳＴＣＯＡＳＴ","1"
"BGR","1"
"AUT","2"
"RUS","8"
"BRA","3"
"SVK","1"
"BEL","3"
"ESP","1"
