id,value
"","57"
"IL","2"
"NY","1"
"CA 92337","1"
"GA","1"
"TX","2"
"AZ","1"
"CA","8"
"MA","2"
"OR","2"
