id,value
"","36"
"SC","1"
"HI","1"
"NY","1"
"GA","1"
"WI","1"
"CA","3"
"OR","1"
"MO 63862","1"
"WA","2"
"VA","1"
"MI","1"
"NM 87801","1"
"ID","1"
"TX","2"
"PA","1"
"NC","1"
"MA","2"
