id,value
"AUS","4"
"ISR","8"
"ZAF","1"
"PAK","1"
"GRC","1"
"ROU","2"
"Europe","2"
"FRA","9"
"KOR","1"
"HUN","1"
"Simferopol","1"
"VNM","1"
"TWN","2"
"CHE","3"
"DNK","3"
"Srinagar","1"
"DEU","20"
"LKA","1"
"SWE","5"
"CZE","1"
"ITA","7"
"CHN","9"
"JPN","1"
"MEX","2"
"CAN","8"
"IDN","3"
"HKG","3"
"IND","18"
"IRN","1"
"UK","19"
"CUB","1"
"ARM","1"
"NLD","4"
"Taiwan 251","1"
"MYS","1"
"SGP","6"
"TUR","4"
"POL","3"
"USA","68"
"AUT","3"
"RUS","8"
"EST","1"
"BRA","5"
"BEL","3"
"UKR","4"
"ESP","5"
