id,value
"AUS","4"
"ISR","2"
"GRC","1"
"FRA","6"
"HUN","1"
"BLR","1"
"GBR","1"
"DNK","1"
"LVA","1"
"DEU","11"
"SWE","4"
"ITA","2"
"CHN","3"
"JPN","1"
"FIN","1"
"MEX","2"
"CAN","6"
"HKG","1"
"IND","8"
"ETH","1"
"UK","12"
"NLD","2"
"SGP","1"
"TUR","1"
"POL","1"
"USA","37"
"NZL","1"
"ＥＡＳＴＣＯＡＳＴ","1"
"AUT","2"
"RUS","2"
"BRA","1"
"UKR","1"
"BEL","3"
"ESP","3"
