id,value
"","158"
"NY","6"
"GA","2"
"TN","1"
"CA","15"
"OK","2"
"MI","2"
"OH","1"
"TX 79927","1"
"FL","3"
"MD","3"
"MA","5"
"IL","4"
"UT","1"
"IN","1"
"WI 54022","1"
"IA 50677","1"
"DC","2"
"AZ","1"
"MO","1"
"OR","6"
"MS 39192","1"
"NH","1"
"WA","5"
"AK","1"
"TX","3"
"CO","5"
