id,value
"","248"
"NY","12"
"OH 45701","1"
"GA","1"
"TN","1"
"CA","19"
"ME","1"
"MI","3"
"MA 02151","1"
"IA","1"
"CA 92620","1"
"FL","2"
"MD","1"
"MA","7"
"TX 79031","2"
"OH 45359","1"
"UT","2"
"IL","5"
"IN","2"
"FL 34786","1"
"MN","1"
"DC","1"
"WI","2"
"AZ","3"
"MO","1"
"OR","3"
"LA","1"
"NH","2"
"WA","4"
"NJ","1"
"NM","1"
"AK","1"
"TX","1"
"CO","1"
"PA","1"
"NC","1"
