id,value
"","192"
"AR","1"
"IL","1"
"NY","6"
"WV","1"
"AZ","1"
"IN 46120","1"
"MO","1"
"CA","29"
"WA 98367","1"
"OR","3"
"LA","1"
"WA","2"
"NJ","3"
"MI","1"
"NM","1"
"TX","2"
"FL","1"
"MD","2"
"PA","4"
"MA","3"
