id,value
"","94"
"AR","1"
"IL","1"
"UT","1"
"NY","2"
"IN","1"
"TN","1"
"AZ","1"
"CA","15"
"WA","1"
"OH","1"
"New England","1"
"NM 87544","1"
"TX","1"
"FL","2"
"PA","1"
"MA","1"
